##########
#----#----
#----#----
#####-###-
#---@--###
#####-###-
#----#----
##########
