----------#
-#########-
---@-------
-#########-
----------#
